50 20
2 2 2 2 2 2 2 2 2 2 2 2 2 2 2 2 2 2 2 2 2 2 2 2 2 2 2 2 2 2 2 2 2 2 2 2 2 2 2 2 2 2 2 2 2 2 2 2 2 2
2 4 0 0 4 0 4 0 4 0 0 0 0 0 0 0 0 0 0 0 0 0 0 0 0 0 0 0 0 0 0 0 0 0 0 0 0 0 0 0 0 0 0 0 0 0 0 3 0 2
2 4 4 0 4 3 0 0 4 1 1 1 1 1 1 1 1 1 1 1 1 1 1 1 1 1 1 1 1 1 1 1 1 1 1 1 0 0 0 0 0 0 3 3 0 2 0 0 0 2
2 4 4 0 0 4 0 4 0 1 1 1 1 0 0 0 0 3 0 0 0 0 3 1 1 1 0 0 0 0 3 1 1 1 1 1 1 0 0 3 0 3 0 0 0 2 0 0 0 2
2 0 4 3 0 4 0 0 1 1 0 3 3 0 0 0 0 0 0 0 4 0 0 1 1 1 0 0 0 0 0 3 3 3 0 0 1 1 0 0 0 1 1 2 2 2 2 2 0 2
2 4 4 4 0 0 0 1 1 3 3 3 0 0 0 3 0 0 0 3 0 0 0 1 1 0 0 0 0 0 0 0 0 0 3 0 0 1 1 0 0 1 0 0 0 2 0 0 0 2
2 4 0 4 0 0 1 1 3 3 0 0 3 0 0 0 0 0 0 0 0 0 0 1 1 0 0 3 0 4 0 0 0 0 0 3 3 0 1 1 0 1 3 3 0 2 0 0 3 2
2 0 0 3 0 1 1 3 0 0 0 0 0 0 0 0 0 0 0 0 3 3 3 3 0 0 0 0 0 0 0 0 0 0 0 0 3 3 0 1 1 1 0 3 0 0 0 0 0 2
2 0 0 0 0 1 1 1 1 1 1 1 1 1 1 1 1 1 3 3 3 0 0 3 0 0 1 1 1 1 1 1 1 1 1 1 1 1 1 1 1 1 1 3 3 3 0 3 3 2
2 0 0 4 0 1 1 1 1 1 1 1 1 1 1 1 1 1 3 0 0 0 0 0 0 0 1 1 1 1 1 1 1 1 1 1 1 1 1 1 1 1 1 0 0 0 0 0 0 2
2 0 0 0 0 1 1 1 1 0 0 0 0 0 0 0 0 0 0 3 3 3 0 0 0 0 0 0 0 1 0 0 0 0 0 0 0 0 0 0 0 0 1 0 0 0 8 0 0 2
2 0 0 3 0 0 1 1 3 0 0 0 0 0 4 0 0 0 0 3 0 3 0 3 0 0 0 0 0 0 0 0 0 0 0 0 0 0 0 0 0 1 1 0 0 8 0 0 0 2
2 6 3 3 3 0 1 1 3 0 0 0 0 3 0 0 3 0 0 3 0 3 0 3 0 0 0 0 0 0 0 0 3 0 0 3 0 3 0 3 3 1 1 0 0 0 0 3 0 2
2 6 6 6 6 6 0 1 1 3 3 3 0 0 0 0 0 0 0 0 0 0 0 0 0 0 0 0 0 3 0 3 3 0 0 3 0 3 3 3 1 1 3 6 3 3 3 6 6 2
2 6 6 6 6 6 3 0 1 1 0 3 3 0 3 0 0 0 0 0 1 0 0 0 0 4 0 0 3 0 0 0 0 3 3 3 3 0 1 1 1 0 1 6 6 1 6 1 6 2
2 6 6 7 6 6 3 0 0 1 1 0 0 0 0 3 0 0 0 0 1 1 0 0 0 0 0 3 0 0 0 3 0 3 0 0 1 1 1 1 1 1 1 1 1 1 1 1 6 2
2 6 6 6 6 6 3 3 0 0 1 1 1 1 0 0 0 0 0 1 1 1 0 3 0 0 0 0 0 0 0 3 0 0 0 1 1 1 0 0 0 3 6 1 6 3 1 6 6 2
2 3 6 6 6 6 6 6 0 0 0 0 0 1 1 1 1 1 1 1 1 1 1 1 1 1 1 1 1 1 1 1 1 1 1 1 0 0 0 0 0 0 6 6 6 6 6 6 6 2
2 2 2 2 2 2 2 2 2 2 2 2 2 2 2 2 2 2 2 2 2 2 2 2 2 2 2 2 2 2 2 2 2 2 2 2 2 2 2 2 2 2 2 2 2 2 2 2 2 2
2 2 2 2 2 2 2 2 2 2 2 2 2 2 2 2 2 2 2 2 2 2 2 2 2 2 2 2 2 2 2 2 2 2 2 2 2 2 2 2 2 2 2 2 2 2 2 2 2 2